########  #############    #
#           #     #  e#    #
#           #  #  #      #    
            #  #  #####     # 
#   b          #      #      #
###################        #
