#########################################################
#                  #                                    #
#                  #                                  e #
#                  #                                    #
#                  #                                    #
#     #            #                                    #
#     #            #                                    #
#     #         ####                                    #
#     #            #                                    #
#   b #            #                                    #
#     #       #                                         #
#########################################################
